    Q   QG  Q    
  EEEEEEEEEEEEEG 
EE             E 
 LE Q   Q   Q EE 
AAAAAAAAAAAAAAAAA