    J   JB  J    
  EEEEEEEEEEEEEB 
EE             E 
 LE J   J   J EE 
AAAAAAAAAAAAAAAAA